name,code,zero,one,two,three,four,pop
China,CHN,56,0,255,481,0,736
France,FRA,55,0,0,735,0,735
Germany,DEU,58,17,117,572,59,748
Italy,ITA,22,7,32,761,0,793
Mexico,MEX,58,583,0,181,0,181
Spain,ESP,69,0,132,508,96,736
Thailand,THA,65,0,300,354,106,760
Turkey,TUR,23,376,61,299,66,426
United Kingdom,GBR,167,35,257,356,0,613
United States,USA,35,21,36,673,58,767